                   _,-}}-._       
                  /\      /\      
                _|(0\\_ _/0)      
               _|/  (__''__)      
             _|\/    WVVVVW       
            \ _\     \MMMM/_      
          _|\_\     _ '---; \_    
     /\   \ _\/      \_   /   \   
    / (    _\/     \   \  |'VVV   
   (  '-,._\_.(      'VVV /       
    \         /   _) /   _)       
     '....--''\__vvv)\__vvv)      